1111111111111111111111111
1E1010000100100001C1011C1
10000000000000C1CCC000001
100C10000011C000P00100101
1001000100000010001000C01
11010CC0010CC0C0100100001
110100000101010C001C00001
1111111111111111111111111