111111111111111111111111111111111111
1101C001000100000010000000000100P011
110100101001C0000C110010100000101111
10E10000010111111001C011100000101011
1000101000C0000100000C0000C000001C11
100100001C00000000100000000000001C11
111111111111111111111111111111111111