111111111111111111111111111111111111
1100C001000100000010000000000100P011
110100101001C0000C110010100000101011
10E10000010111111001C011100000101011
1000001000C0000100000C0000C000000C11
100C00001C00000000100000000000001C11
111111111111111111111111111111111111