1111111111111111111111111
1E0010000100100111C1011C1
10100000000000C1CCC100001
100C10000011C000P00000001
1001000100000010001000C11
11010CC0010CC0C0100100111
110100000101010C001C000C1
1111111111111111111111111