11111C11111PE1111111111111
11111C11111PE1111111111111
